NO ./textures/north.xpm
SO ./textures/south.xpm
WE ./textures/west.xpm
EA ./textures/east.xpm

F 220,100,0
C 225,200,0

          1111111111111111
		  1000000010000001
		  1100000000000001
11111111111000000000000001
1000N000000000000000011111
1000000000000000000001
1111111111111111111111
