NO ./textures/north.xpm
SO ./textures/south.xpm
WE ./textures/west.xpm
EA ./textures/east.xpm

F 220,100,0
C 250,200,30

1111111111111111
1000N00010100001
1100000010000001
1111111111111111
1000000000000001
1001110001110001
1111 11111 11111