NO ./textures/north.xpm
SO ./textures/south.xpm
WE ./textures/west.xpm
EA ./textures/east.xpm

F 120,100,120
C 100,100,255

11111111111111
1S000000000001
10111110111101
100000N0000001
10111110111101
10000000000001
11111111111111