NO ./textures/north.xpm
SO ./textures/south.xpm
WE ./textures/west.xpm
EA ./textures/east.xpm

F 80,80,80
C 160,160,160

111111111111111
1N0000000000001
101111101111101
100000101000001
101111101111101
100000000000001
111111111111111