NO ./textures/north.xpm
SO ./textures/south.xpm
WE ./textures/west.xpm
EA ./textures/east.xpm

F 220,100,0
C 250,200,30

          1111111111111111
          1000000010000001
          110000000001
1111111111100000000001
1000N000000000000000011111
100111001110001110sw001
1111 11111 11111 11111