NO ./textures/north.xpm
SO ./textures/south.xpm
WE ./textures/west.xpm
EA ./textures/east.xpm

F 0,0,0
C 255,255,255

111111111111111111
1N0000000000000001
111101111111110101
100001000001000101
101111011101110101
101000000001000101
101011111111110101
100000000000000001
111111111111111111