NO ./textures/north.xpm
SO ./textures/south.xpm
WE ./textures/west.xpm
EA ./textures/east.xpm

F 100,100,100
C 200,200,200

1111111111111111
1000000000000001
1011110111111101
1010000100000101
1010111101110101
1010100001010101
1010111111010101
1000000000010N01
1111111111111111